Italian - ti amo

german- ich liebe dich
gujarati - Hu tamne prem karu chhu
nepali - ma timilai maya garchu
panjabi - Meno Tere Na Pyar Wa
sanskrit - tvayi snihyaami
bengali - ami tumake bhalo basi

english - I love you

Hindi - mein tumse pyaar karti hoon

telugu - nenu ninnu premistunnanu

marathi - mi tujhyavara prema karato

Tamil - nan unnai necikkiren

Bhojpuri - ham tohara se pyar karila

panjabi - Menu Twadey Naal Pyar Hai

Kannada - Naanu ninanu pritisutene

Malyalam - nan ninne snehikkunnu
urdu - Mein tumse mohabbat karta hun

Odia - mu tumaku bhala paye

Panjabi - Main tenu pyar karda haan


 Rajasthani -  hu/mhey thaaneh prem karu 6u

Chhattisgarhi - main tor se maya karatho

Assamese - moi tumak val pau

maithili - hom ahaan sei pyaar karey chhi

magadhi - hum tohara se pyaar kar hiy0


haryanvi - ma tanna pyaar karun hun

nagpuri - moy toke chahona
santali - ing aming sibilama
kashmiri - meh chi chain maai

bundel khandi - hum tumhe chahat hein

manipuri - aina nangbu nunshi

konkani - hanv tukka preeti karta
sindhi - maa tokhe pyar kendo ahyan
 